NO ./textures/brick.xpm
SO ./textures/blue.xpm
WE ./textures/wood.xpm
EA ./textures/grey.xpm

F 0,153,76
C 102,178,255

111111111111111111
100000000000000001
100000000000000001
100000000000000001
100000000000011111
100000000000000001
100000001000000001
100000000000000001
1000000000N0000001
111111111101111111
        1100111111111111111111111
        1000000000110000000000001
        1011000001110000000000001
        1001000000000000000000001
111111111011000001110000000000001
100000000011000001110111111111111
11110000011000001100000010001
11110000011111011101010010001
11000000110101011100000010101
10000000000000000000000010001
10000000000000001101010000001
11000001110101011111011110001
11110111 1110101 101111010001
11111111 1111111 111111111111
